Am_Exer
An Interactive Fiction by Gruppe1
Release 1 / Serial number 160330 / Inform 7 build 6M62 (I6/v6.33 lib 6/12N) SD

051 Labor
Ein Labor. 
Hier finden spannende Versuche statt.

>go north
Hallway0_w1
south: 051 Labor 
north: Treppe EG_w

>go west
Hallway0_w2

>go north
WC

>urinate
That's not a verb I recognise.

* * *

>go north
Hallway0_w1
south: 051 Labor 
north: Treppe EG_w

>go south
051 Labor
Ein Labor. 
Irre!

* * *

Am_Exer
An Interactive Fiction by Gruppe1
Release 1 / Serial number 160330 / Inform 7 build 6M62 (I6/v6.33 lib 6/12N) SD

051 Labor
Ein Labor. 
Hier finden spannende Versuche statt.

>go south
Hallway0_w1
south: 051 Labor 
north: Treppe EG_w

>go west
Hallway0_w2

>go west
Hallway0_w3

* * *

>go west
Hallway0_w2

>gi w
That's not a verb I recognise.

>go west
Hallway0_w3
south: Raum 052 
north: Raum 059

>go east
Hallway0_w2

* * *

>go south
Hallway0_w1
south: 051 Labor 
north: Treppe EG_w

>go south
051 Labor

>go north
Hallway0_w1
south: 051 Labor 
north: Treppe EG_w

>go west
Hallway0_w2
north: WC m

>go west
Hallway0_w3
south: Raum 052 
north: Raum 059

>go west
Hallway0_w4

>go west
You can't go that way.

>go east
Hallway0_w3
south: Raum 052 
north: Raum 059

* * *

Am_Exer
An Interactive Fiction by Gruppe1
Release 1 / Serial number 160330 / Inform 7 build 6M62 (I6/v6.33 lib 6/12N) SD

051 Labor
Ein Labor. 
Hier finden spannende Versuche statt.

>go around
You can't see any such thing.

>go Hallway0_w1
You can't see any such thing.

>go south
Hallway0_w1
south: 051 Labor 
north: Treppe EG_w

* * *

Am_Exer
An Interactive Fiction by Gruppe1
Release 1 / Serial number 160330 / Inform 7 build 6M62 (I6/v6.33 lib 6/12N) SD

051 Labor
Ein Labor. 
Hier finden spannende Versuche statt.

>go west
You can't go that way.

>go north
Hallway0_w1
south: 051 Labor 
north: Treppe EG_w

* * *

>go west
Hallway0_w3
south: Raum 052 
north: Raum 059

>go west
Hallway0_w4
south: 053 Labor 
north: Raum 058

>go west
Hallway0_w5
south: Raum 054 
north: 057 Labor

>go west
Hallway0_w6
 HAUPTFLUR. Enthält Kartenaufladegerät & Kopierer
south: 055 Labor & 056 Labor

>go west
You can't go that way.

>go north
Hallway0_w7
east: WC m 
west: Raum 074

>go east
WC0_w2
WC (m)